{
  "tileSize": 16,
  "mapWidth": 49,
  "mapHeight": 12,
  "layers": [
    {
      "name": "Layer_0",
      "tiles": [
        { "id": "0", "x": 0, "y": 11 },
        { "id": "1", "x": 1, "y": 11 },
        { "id": "0", "x": 2, "y": 11 },
        { "id": "1", "x": 3, "y": 11 },
        { "id": "0", "x": 4, "y": 11 },
        { "id": "1", "x": 5, "y": 11 },
        { "id": "0", "x": 6, "y": 11 },
        { "id": "1", "x": 7, "y": 11 },
        { "id": "2", "x": 10, "y": 9 },
        { "id": "3", "x": 11, "y": 9 },
        { "id": "2", "x": 15, "y": 9 },
        { "id": "3", "x": 16, "y": 9 },
        { "id": "4", "x": 17, "y": 9 },
        { "id": "5", "x": 18, "y": 9 },
        { "id": "6", "x": 19, "y": 9 },
        { "id": "7", "x": 20, "y": 9 },
        { "id": "8", "x": 21, "y": 9 },
        { "id": "9", "x": 22, "y": 9 },
        { "id": "10", "x": 23, "y": 9 },
        { "id": "9", "x": 24, "y": 9 },
        { "id": "10", "x": 25, "y": 9 },
        { "id": "9", "x": 26, "y": 9 },
        { "id": "10", "x": 27, "y": 9 },
        { "id": "2", "x": 7, "y": 5 },
        { "id": "3", "x": 8, "y": 5 },
        { "id": "11", "x": 0, "y": 8 },
        { "id": "12", "x": 0, "y": 9 },
        { "id": "13", "x": 0, "y": 10 },
        { "id": "14", "x": 30, "y": 7 },
        { "id": "14", "x": 33, "y": 10 },
        { "id": "15", "x": 37, "y": 10 },
        { "id": "16", "x": 38, "y": 10 },
        { "id": "17", "x": 37, "y": 11 },
        { "id": "18", "x": 38, "y": 11 },
        { "id": "15", "x": 39, "y": 10 },
        { "id": "16", "x": 40, "y": 10 },
        { "id": "17", "x": 39, "y": 11 },
        { "id": "18", "x": 40, "y": 11 },
        { "id": "19", "x": 44, "y": 9 },
        { "id": "20", "x": 45, "y": 9 },
        { "id": "19", "x": 46, "y": 9 },
        { "id": "20", "x": 47, "y": 9 }
      ],
      "collider": false
    },
    {
      "name": "Layer_1",
      "tiles": [
        { "id": "21", "x": 23, "y": 8 },
        { "id": "22", "x": 8, "y": 3 },
        { "id": "23", "x": 8, "y": 4 },
        { "id": "24", "x": 7, "y": 2 },
        { "id": "25", "x": 8, "y": 2 },
        { "id": "26", "x": 9, "y": 2 },
        { "id": "27", "x": 0, "y": 11 },
        { "id": "28", "x": 1, "y": 11 },
        { "id": "29", "x": 2, "y": 11 },
        { "id": "30", "x": 3, "y": 11 },
        { "id": "31", "x": 4, "y": 11 },
        { "id": "32", "x": 5, "y": 11 },
        { "id": "33", "x": 6, "y": 11 },
        { "id": "34", "x": 7, "y": 11 },
        { "id": "27", "x": 8, "y": 11 },
        { "id": "28", "x": 9, "y": 11 },
        { "id": "29", "x": 10, "y": 11 },
        { "id": "30", "x": 11, "y": 11 },
        { "id": "31", "x": 12, "y": 11 },
        { "id": "32", "x": 13, "y": 11 },
        { "id": "33", "x": 14, "y": 11 },
        { "id": "34", "x": 15, "y": 11 },
        { "id": "27", "x": 16, "y": 11 },
        { "id": "28", "x": 17, "y": 11 },
        { "id": "29", "x": 18, "y": 11 },
        { "id": "30", "x": 19, "y": 11 },
        { "id": "31", "x": 20, "y": 11 },
        { "id": "32", "x": 21, "y": 11 },
        { "id": "33", "x": 22, "y": 11 },
        { "id": "34", "x": 23, "y": 11 },
        { "id": "27", "x": 24, "y": 11 },
        { "id": "28", "x": 25, "y": 11 },
        { "id": "29", "x": 26, "y": 11 },
        { "id": "30", "x": 27, "y": 11 },
        { "id": "31", "x": 28, "y": 11 },
        { "id": "32", "x": 29, "y": 11 },
        { "id": "33", "x": 30, "y": 11 },
        { "id": "34", "x": 31, "y": 11 },
        { "id": "27", "x": 32, "y": 11 },
        { "id": "28", "x": 33, "y": 11 },
        { "id": "29", "x": 34, "y": 11 },
        { "id": "30", "x": 35, "y": 11 },
        { "id": "31", "x": 44, "y": 11 },
        { "id": "32", "x": 45, "y": 11 },
        { "id": "33", "x": 46, "y": 11 },
        { "id": "34", "x": 47, "y": 11 },
        { "id": "27", "x": 36, "y": 11 },
        { "id": "28", "x": 37, "y": 11 },
        { "id": "29", "x": 38, "y": 11 },
        { "id": "30", "x": 39, "y": 11 },
        { "id": "31", "x": 40, "y": 11 },
        { "id": "32", "x": 41, "y": 11 },
        { "id": "33", "x": 42, "y": 11 },
        { "id": "34", "x": 43, "y": 11 }
      ],
      "collider": false
    },
    {
      "name": "Layer_2",
      "tiles": [
        { "id": "35", "x": 37, "y": 8 },
        { "id": "36", "x": 38, "y": 8 },
        { "id": "37", "x": 39, "y": 8 },
        { "id": "38", "x": 37, "y": 9 },
        { "id": "39", "x": 38, "y": 9 },
        { "id": "40", "x": 39, "y": 9 },
        { "id": "41", "x": 37, "y": 10 },
        { "id": "42", "x": 38, "y": 10 },
        { "id": "43", "x": 39, "y": 10 },
        { "id": "44", "x": 37, "y": 11 },
        { "id": "45", "x": 38, "y": 11 },
        { "id": "46", "x": 39, "y": 11 },
        { "id": "35", "x": 40, "y": 8 },
        { "id": "36", "x": 41, "y": 8 },
        { "id": "37", "x": 42, "y": 8 },
        { "id": "38", "x": 40, "y": 9 },
        { "id": "39", "x": 41, "y": 9 },
        { "id": "40", "x": 42, "y": 9 },
        { "id": "41", "x": 40, "y": 10 },
        { "id": "42", "x": 41, "y": 10 },
        { "id": "43", "x": 42, "y": 10 },
        { "id": "44", "x": 40, "y": 11 },
        { "id": "45", "x": 41, "y": 11 },
        { "id": "46", "x": 42, "y": 11 },
        { "id": "35", "x": 43, "y": 8 },
        { "id": "36", "x": 44, "y": 8 },
        { "id": "37", "x": 45, "y": 8 },
        { "id": "38", "x": 43, "y": 9 },
        { "id": "39", "x": 44, "y": 9 },
        { "id": "40", "x": 45, "y": 9 },
        { "id": "41", "x": 43, "y": 10 },
        { "id": "42", "x": 44, "y": 10 },
        { "id": "43", "x": 45, "y": 10 },
        { "id": "44", "x": 43, "y": 11 },
        { "id": "45", "x": 44, "y": 11 },
        { "id": "46", "x": 45, "y": 11 },
        { "id": "35", "x": 46, "y": 8 },
        { "id": "36", "x": 47, "y": 8 },
        { "id": "37", "x": 48, "y": 8 },
        { "id": "38", "x": 46, "y": 9 },
        { "id": "39", "x": 47, "y": 9 },
        { "id": "40", "x": 48, "y": 9 },
        { "id": "41", "x": 46, "y": 10 },
        { "id": "42", "x": 47, "y": 10 },
        { "id": "43", "x": 48, "y": 10 },
        { "id": "44", "x": 46, "y": 11 },
        { "id": "45", "x": 47, "y": 11 },
        { "id": "46", "x": 48, "y": 11 },
        { "id": "35", "x": 37, "y": 4 },
        { "id": "36", "x": 38, "y": 4 },
        { "id": "37", "x": 39, "y": 4 },
        { "id": "38", "x": 37, "y": 5 },
        { "id": "39", "x": 38, "y": 5 },
        { "id": "40", "x": 39, "y": 5 },
        { "id": "41", "x": 37, "y": 6 },
        { "id": "42", "x": 38, "y": 6 },
        { "id": "43", "x": 39, "y": 6 },
        { "id": "44", "x": 37, "y": 7 },
        { "id": "45", "x": 38, "y": 7 },
        { "id": "46", "x": 39, "y": 7 },
        { "id": "35", "x": 40, "y": 4 },
        { "id": "36", "x": 41, "y": 4 },
        { "id": "37", "x": 42, "y": 4 },
        { "id": "38", "x": 40, "y": 5 },
        { "id": "39", "x": 41, "y": 5 },
        { "id": "40", "x": 42, "y": 5 },
        { "id": "41", "x": 40, "y": 6 },
        { "id": "42", "x": 41, "y": 6 },
        { "id": "43", "x": 42, "y": 6 },
        { "id": "44", "x": 40, "y": 7 },
        { "id": "45", "x": 41, "y": 7 },
        { "id": "46", "x": 42, "y": 7 },
        { "id": "35", "x": 43, "y": 4 },
        { "id": "36", "x": 44, "y": 4 },
        { "id": "37", "x": 45, "y": 4 },
        { "id": "38", "x": 43, "y": 5 },
        { "id": "39", "x": 44, "y": 5 },
        { "id": "40", "x": 45, "y": 5 },
        { "id": "41", "x": 43, "y": 6 },
        { "id": "42", "x": 44, "y": 6 },
        { "id": "43", "x": 45, "y": 6 },
        { "id": "44", "x": 43, "y": 7 },
        { "id": "45", "x": 44, "y": 7 },
        { "id": "46", "x": 45, "y": 7 },
        { "id": "35", "x": 46, "y": 4 },
        { "id": "36", "x": 47, "y": 4 },
        { "id": "37", "x": 48, "y": 4 },
        { "id": "38", "x": 46, "y": 5 },
        { "id": "39", "x": 47, "y": 5 },
        { "id": "40", "x": 48, "y": 5 },
        { "id": "41", "x": 46, "y": 6 },
        { "id": "42", "x": 47, "y": 6 },
        { "id": "43", "x": 48, "y": 6 },
        { "id": "44", "x": 46, "y": 7 },
        { "id": "45", "x": 47, "y": 7 },
        { "id": "46", "x": 48, "y": 7 },
        { "id": "35", "x": 37, "y": 0 },
        { "id": "36", "x": 38, "y": 0 },
        { "id": "37", "x": 39, "y": 0 },
        { "id": "38", "x": 37, "y": 1 },
        { "id": "39", "x": 38, "y": 1 },
        { "id": "40", "x": 39, "y": 1 },
        { "id": "41", "x": 37, "y": 2 },
        { "id": "42", "x": 38, "y": 2 },
        { "id": "43", "x": 39, "y": 2 },
        { "id": "44", "x": 37, "y": 3 },
        { "id": "45", "x": 38, "y": 3 },
        { "id": "46", "x": 39, "y": 3 },
        { "id": "35", "x": 40, "y": 0 },
        { "id": "36", "x": 41, "y": 0 },
        { "id": "37", "x": 42, "y": 0 },
        { "id": "38", "x": 40, "y": 1 },
        { "id": "39", "x": 41, "y": 1 },
        { "id": "40", "x": 42, "y": 1 },
        { "id": "41", "x": 40, "y": 2 },
        { "id": "42", "x": 41, "y": 2 },
        { "id": "43", "x": 42, "y": 2 },
        { "id": "44", "x": 40, "y": 3 },
        { "id": "45", "x": 41, "y": 3 },
        { "id": "46", "x": 42, "y": 3 },
        { "id": "35", "x": 43, "y": 0 },
        { "id": "36", "x": 44, "y": 0 },
        { "id": "37", "x": 45, "y": 0 },
        { "id": "38", "x": 43, "y": 1 },
        { "id": "39", "x": 44, "y": 1 },
        { "id": "40", "x": 45, "y": 1 },
        { "id": "41", "x": 43, "y": 2 },
        { "id": "42", "x": 44, "y": 2 },
        { "id": "43", "x": 45, "y": 2 },
        { "id": "44", "x": 43, "y": 3 },
        { "id": "45", "x": 44, "y": 3 },
        { "id": "46", "x": 45, "y": 3 },
        { "id": "35", "x": 46, "y": 0 },
        { "id": "36", "x": 47, "y": 0 },
        { "id": "37", "x": 48, "y": 0 },
        { "id": "38", "x": 46, "y": 1 },
        { "id": "39", "x": 47, "y": 1 },
        { "id": "40", "x": 48, "y": 1 },
        { "id": "41", "x": 46, "y": 2 },
        { "id": "42", "x": 47, "y": 2 },
        { "id": "43", "x": 48, "y": 2 },
        { "id": "44", "x": 46, "y": 3 },
        { "id": "45", "x": 47, "y": 3 },
        { "id": "46", "x": 48, "y": 3 },
        { "id": "35", "x": 34, "y": 8 },
        { "id": "36", "x": 35, "y": 8 },
        { "id": "37", "x": 36, "y": 8 },
        { "id": "38", "x": 34, "y": 9 },
        { "id": "39", "x": 35, "y": 9 },
        { "id": "40", "x": 36, "y": 9 },
        { "id": "41", "x": 34, "y": 10 },
        { "id": "42", "x": 35, "y": 10 },
        { "id": "43", "x": 36, "y": 10 },
        { "id": "44", "x": 34, "y": 11 },
        { "id": "45", "x": 35, "y": 11 },
        { "id": "46", "x": 36, "y": 11 },
        { "id": "35", "x": 34, "y": 4 },
        { "id": "36", "x": 35, "y": 4 },
        { "id": "37", "x": 36, "y": 4 },
        { "id": "38", "x": 34, "y": 5 },
        { "id": "39", "x": 35, "y": 5 },
        { "id": "40", "x": 36, "y": 5 },
        { "id": "41", "x": 34, "y": 6 },
        { "id": "42", "x": 35, "y": 6 },
        { "id": "43", "x": 36, "y": 6 },
        { "id": "44", "x": 34, "y": 7 },
        { "id": "45", "x": 35, "y": 7 },
        { "id": "46", "x": 36, "y": 7 },
        { "id": "35", "x": 34, "y": 0 },
        { "id": "36", "x": 35, "y": 0 },
        { "id": "37", "x": 36, "y": 0 },
        { "id": "38", "x": 34, "y": 1 },
        { "id": "39", "x": 35, "y": 1 },
        { "id": "40", "x": 36, "y": 1 },
        { "id": "41", "x": 34, "y": 2 },
        { "id": "42", "x": 35, "y": 2 },
        { "id": "43", "x": 36, "y": 2 },
        { "id": "44", "x": 34, "y": 3 },
        { "id": "45", "x": 35, "y": 3 },
        { "id": "46", "x": 36, "y": 3 },
        { "id": "35", "x": 31, "y": 0 },
        { "id": "36", "x": 32, "y": 0 },
        { "id": "37", "x": 33, "y": 0 },
        { "id": "38", "x": 31, "y": 1 },
        { "id": "39", "x": 32, "y": 1 },
        { "id": "40", "x": 33, "y": 1 },
        { "id": "41", "x": 31, "y": 2 },
        { "id": "42", "x": 32, "y": 2 },
        { "id": "43", "x": 33, "y": 2 },
        { "id": "44", "x": 31, "y": 3 },
        { "id": "45", "x": 32, "y": 3 },
        { "id": "46", "x": 33, "y": 3 },
        { "id": "35", "x": 31, "y": 8 },
        { "id": "36", "x": 32, "y": 8 },
        { "id": "37", "x": 33, "y": 8 },
        { "id": "38", "x": 31, "y": 9 },
        { "id": "39", "x": 32, "y": 9 },
        { "id": "40", "x": 33, "y": 9 },
        { "id": "41", "x": 31, "y": 10 },
        { "id": "42", "x": 32, "y": 10 },
        { "id": "43", "x": 33, "y": 10 },
        { "id": "44", "x": 31, "y": 11 },
        { "id": "45", "x": 32, "y": 11 },
        { "id": "46", "x": 33, "y": 11 },
        { "id": "35", "x": 31, "y": 4 },
        { "id": "36", "x": 32, "y": 4 },
        { "id": "37", "x": 33, "y": 4 },
        { "id": "38", "x": 31, "y": 5 },
        { "id": "39", "x": 32, "y": 5 },
        { "id": "40", "x": 33, "y": 5 },
        { "id": "41", "x": 31, "y": 6 },
        { "id": "42", "x": 32, "y": 6 },
        { "id": "43", "x": 33, "y": 6 },
        { "id": "44", "x": 31, "y": 7 },
        { "id": "45", "x": 32, "y": 7 },
        { "id": "46", "x": 33, "y": 7 },
        { "id": "35", "x": 28, "y": 0 },
        { "id": "36", "x": 29, "y": 0 },
        { "id": "37", "x": 30, "y": 0 },
        { "id": "38", "x": 28, "y": 1 },
        { "id": "39", "x": 29, "y": 1 },
        { "id": "40", "x": 30, "y": 1 },
        { "id": "41", "x": 28, "y": 2 },
        { "id": "42", "x": 29, "y": 2 },
        { "id": "43", "x": 30, "y": 2 },
        { "id": "44", "x": 28, "y": 3 },
        { "id": "45", "x": 29, "y": 3 },
        { "id": "46", "x": 30, "y": 3 },
        { "id": "35", "x": 28, "y": 4 },
        { "id": "36", "x": 29, "y": 4 },
        { "id": "37", "x": 30, "y": 4 },
        { "id": "38", "x": 28, "y": 5 },
        { "id": "39", "x": 29, "y": 5 },
        { "id": "40", "x": 30, "y": 5 },
        { "id": "41", "x": 28, "y": 6 },
        { "id": "42", "x": 29, "y": 6 },
        { "id": "43", "x": 30, "y": 6 },
        { "id": "44", "x": 28, "y": 7 },
        { "id": "45", "x": 29, "y": 7 },
        { "id": "46", "x": 30, "y": 7 },
        { "id": "35", "x": 28, "y": 8 },
        { "id": "36", "x": 29, "y": 8 },
        { "id": "37", "x": 30, "y": 8 },
        { "id": "38", "x": 28, "y": 9 },
        { "id": "39", "x": 29, "y": 9 },
        { "id": "40", "x": 30, "y": 9 },
        { "id": "41", "x": 28, "y": 10 },
        { "id": "42", "x": 29, "y": 10 },
        { "id": "43", "x": 30, "y": 10 },
        { "id": "44", "x": 28, "y": 11 },
        { "id": "45", "x": 29, "y": 11 },
        { "id": "46", "x": 30, "y": 11 }
      ],
      "collider": false
    }
  ]
}
